111111111111111111111111111111111
1P0000000000000000000000000000001
100000100001000011111110000000001
100000100001000000000010000000001
100000100001000000000110000000001
100000111111000000011000000000001
100000000001000011100000000000001
100000000001000010000000000000001
100000000001000011111110000000001
1000C000000000C0000000000C00000E1
111111111111111111111111111111111