111111111111111111111111111111111
100000000000000000000000000000001
100000100001000011111110000000001
1000001000010000000000100000C0001
10000010000100D000000110000000001
100P0011111100D0000110000000C0001
100000000001000011100000000000001
100000000001000010000000000000001
100000000001000011111110000000001
1000C000000000C0000000000C00000E1
111111111111111111111111111111111