111111111111111111111111111111111
1P0000000000000000000000000000001
100000100001000001111110000000001
100000100001000000000010000000001
100000100001000000000010000000001
100000111111000000001000000000001
100000000001000000100000000000001
100000000001000010000000000000001
100000000001000011111110000000001
10000000000000C0000000000000000E1
111111111111111111111111111111111