1111111111111
1E00000000001
10100101C0101
101001CP10101
100000000C001
1111111111111