111111111111111111111111111111
1P000C000000000000000000000001
100000000000000000000000000001
10000000000000C000000000C00001

10000C00000000000000000000E001
111111111111111111111111111111