11111111111111111
00000000000000000
11111111P11111111
0111111E111111111
000000C1111111111