1111111111
10010000E1
1001100001
1000010101
1111000011
1000000001
1000010001
1000010111
1P000101C1
1111111111