1111111111111111111111111111111111
1E00000000D0000C00000C00000000D001
10100101001000001D1001000D00010101
1010010010101010001001000000010101
1P0000000C00C0000000000000000000C1
1111111111111111111111111111111111